	NO ./assets/textures/validTextures/north.xpm
		SO ./assets/textures/validTextures/south.xpm
			WE ./assets/textures/validTextures/west.xpm
                EA ./assets/textures/validTextures/east.xpm

F     101     ,183,65		
C  123,            211  ,  234    

1111111111
1000000001
1000000001
100000N001
1001000001
1001110101
1000010101
1000010101
1000000001
1111111111