NO ./textures/north.xpm
SO ./textures/south.xpm
WE ./textures/west.xpm
EA ./textures/east.xpm

C 35,19,73

F 15,6,40

11111
10001
100E1
11111