NO ./textures/north.xpm
SO ./textures/south.xpm
WE ./textures/west.xpm
EA ./textures/east.xpm

C 255, 255, 255

F 255, 255, 255

   111
   101
111101
1000N1
111111