NO ./textures/north.xpm
SO ./textures/south.xpm
WE ./textures/west.xpm
EA ./textures/east.xpm

C 255,255,255
F 255,255,255

11111
10001
100E1
11111
