NO ./textures/north.xpm
SO ./textures/south.xpm
WE ./textures/west.xpm
EA ./textures/east.xpm

C                     35,                     19,                     222
F                      115,                     6,                     40

11111
10001
100E1
11111
