NO ./assets/textures/validTextures/north.xpm
SO ./assets/textures/validTextures/south.xpm
WE ./assets/textures/validTextures/west.xpm
EA ./assets/textures/validTextures/east.xpm

F  101, 183, 65
C  123, 211, 230


 111111
10000001
1N001001
10000001
 111111