NO ./assets/textures/validTextures/north.xpm
SO ./assets/textures/validTextures/south.xpm
WE ./assets/textures/validTextures/west.xpm
EA ./assets/textures/validTextures/east.xpm

F  101, 183, 65
C  123, 211, 230

11111  111
10000  101
10101  101
10N01  101
11111  111
