NO ../../textures/validTextures/noth.xpm
SO ../../textures/validTextures/south.xpm
EA ../../textures/validTextures/east.xpm
WE ../../textures/validTextures/west.xpm

C 255,255,255

F 0,255,256

   111
   101
111101
1000N1
111111